Wir  ====   we
vertrauen    ====   to trust
darauf   ====   thereon
dass     ====   that
die  ====   the
Zeit     ====   Time
linear   ====   linear
verläuft     ====   run
Dass     ====   That
sie  ====   she
auf  ====   on
ewig     ====   eternal
gleichförmig     ====   uniform
voranschreitet   ====   progress
Bis  ====   To
in   ====   in
Unendlichkeit    ====   infinity
Aber     ====   but
Unterscheidung   ====   Distinction
von  ====   from
Vergangenheit    ====   past
Gegenwart    ====   presence
und  ====   and
Zukunft  ====   future
ist  ====   is
nichts   ====   nothing
als  ====   as
eine     ====   one
Illusion     ====   illusion
Gestern  ====   Yesterday
heute    ====   today
morgen   ====   morning
folgen   ====   follow
nicht    ====   not
aufeinander  ====   on each other
Sie  ====   she
sind     ====   are
einem    ====   a
ewigen   ====   eternal
Kreis    ====   circle
miteinander  ====   together
verbunden    ====   tied together
Alles    ====   Everything
Mama     ====   mummy
Mit  ====   With
müssten  ====   be
sich     ====   themselves
selber   ====   himself
Toast    ====   toast
machen   ====   do
können   ====   can
Der  ====   Of the
Strom    ====   current
geht     ====   goes
wieder   ====   again
Danke    ====   thanks
fürs     ====   for
Frühstück    ====   breakfast
Kommst   ====   Come
du   ====   you
zur  ====   to the
Versammlung  ====   Assembly
Ich  ====   I
weiß     ====   White
Katharina    ====   Catharina
da   ====   there
Und  ====   and
ich  ====   I
bin  ====   am
Ja   ====   Yes
bist     ====   are you
Genau    ====   Exactly
Ulrich   ====   Ulrich
liebe    ====   love
dich     ====   you
Schön    ====   Nice
Wie  ====   As
war  ====   was
es   ====   it
für  ====   for
waren    ====   was
letzten  ====   last
zwei     ====   two
Monate   ====   months
Du   ====   You
musst    ====   must
drüber   ====   over
reden    ====   talk
wenn     ====   if
willst   ====   want
hab  ====   have
den  ====   the
medizinischen    ====   medical
Bericht  ====   report
gelesen  ====   had read
hast     ====   have
gut  ====   Well
mitgemacht   ====   fellow
vor  ====   before
allem    ====   all
Gruppensitzungen     ====   Group sessions
seh  ====   see
ihn  ====   him
immer    ====   always
noch     ====   still
In   ====   In
deinen   ====   yours
Träumen  ====   dream
Was  ====   What
glaubst  ====   believe
warum    ====   why
Sollten  ====   Should
mir  ====   me
das  ====   the
Therapeut    ====   therapist
sagen    ====   to say
Nimmst   ====   Take
Medikamente  ====   Drug
glaube   ====   faith
er   ====   he
will     ====   want
etwas    ====   some
vielleicht   ====   perhaps
auch     ====   even
nur  ====   only
was  ====   What
sein     ====   be
könnte   ====   could
Warum    ====   why
gegangen     ====   went
so   ====   so
Scheiße  ====   crap
mal  ====   times
erhängt  ====   hung
hat  ====   Has
kein     ====   no
Wort     ====   word
hinterlassen     ====   leave behind
Nichts   ====   nothing
diese    ====   these
ganze    ====   whole
erklärt  ====   explained
Das  ====   That
AKW  ====   Akw
Winden   ====   Wind
lange    ====   Long
Geschichte   ====   story
Pläne    ====   plans
Errichtung   ====   Establishment
des  ====   of
Kraftwerks   ====   Power plant
wurden   ====   became
bereits  ====   already
im   ====   in the
Jahr     ====   year
geschmiedet  ====   forged
Allerdings   ====   However
wurde    ====   became
der  ====   the
Bau  ====   building
erst     ====   first
nach     ====   after
dem  ====   to the
Atomgesetz   ====   Atomic law
bewilligt    ====   approved
Im   ====   in the
Zuge     ====   Trains
Regierung    ====   government
schrittweise     ====   gradual
geplanten    ====   planned
Atomausstiegs    ====   Nuclear
wird     ====   will
nun  ====   well
aber     ====   but
Meiler   ====   Meiler
vom  ====   from the
Netz     ====   network
gehen    ====   walk
müssen   ====   have to
Damit    ====   In order to
gehört   ====   heard
zu   ====   to
am   ====   at the
längsten     ====   long
störungsfrei     ====   trouble-free
betriebenen  ====   operated
deutschen    ====   German
AKWs     ====   Akws
Mikkel   ====   Mikkel
gehst    ====   go
Schule   ====   school
Einen    ====   A
Zauberer     ====   wizard
muss     ====   got to
man  ====   one
wiedererkennen   ====   recover
Umziehen     ====   Relocate
schön    ====   Nice
meine    ====   my
Arbeitskleidung  ====   Workwear
außerdem     ====   aside from that
scheiße  ====   crap
Haudini  ====   Haudini
sicher   ====   for sure
Houdini  ====   Houdini
Martha   ====   Martha
kommst   ====   come
frühstücken  ====   have breakfast
Bist     ====   Are you
adoptiert    ====   adopted
Mann     ====   man
nervst   ====   nervous
heißt    ====   called
Aua  ====   Aua
Wo   ====   Where
mein     ====   my
schwarzer    ====   black
Kapuzenpulli     ====   Hoodie
Vielleicht   ====   Maybe
bei  ====   at
Jacken   ====   Jackets
Musst    ====   Must
trampeln     ====   trample
Morgen   ====   morning
Guten    ====   good
gedauert     ====   took
Erster   ====   First
Schultag     ====   school day
Riesenschlange   ====   Huge snake
beim     ====   at the
Bäcker   ====   Baker
Die  ====   the
Apokalypse   ====   Apocalypse
naht     ====   seam
zum  ====   to the
Essen    ====   eat
deiner   ====   yours
Sporttasche  ====   Sports bag
denn     ====   because
los  ====   Come on
Hungerstreik     ====   Hunger strike
Alle     ====   All
zehn     ====   ten
Sekunden     ====   Seconds
verhungert   ====   starved
ein  ====   a
Kind     ====   child
fresse   ====   face
mich     ====   me
voll     ====   fully
Scheißpulli  ====   Shit
Tasche   ====   bag
Hast     ====   Have
meinen   ====   say
Pulli    ====   Sweater
geklaut  ====   Stolen
Nein     ====   no
Könnt    ====   Can
ihr  ====   your
euch     ====   you
vertragen    ====   tolerate
gemacht  ====   made
kann     ====   can
Kriege   ====   Wars
Text     ====   text
Dein     ====   Your
Wäsche   ====   Laundry
Wenn     ====   if
verhungerst  ====   starving
nützt    ====   beneficial
keinem   ====   no
zieh     ====   pull
um   ====   around
Letzte   ====   Last
Verwarnung   ====   warning
kommen   ====   come
spät     ====   late
Wer  ====   who
wollte   ====   wanted to
Kinder   ====   children
Machst   ====   Make
stehst   ====   stand
Weg  ====   path
verstanden   ====   Understood
Also     ====   So
Ein  ====   A
letzter  ====   last
Trick    ====   trick
dann     ====   then
ab   ====   away
ja   ====   Yes
Gut  ====   Good
macht    ====   power
hier     ====   here
eben     ====   just
jeder    ====   everyone
Hab  ====   Have
Okay     ====   OK
Zack     ====   Zack
Wahnsinn     ====   insanity
Papa     ====   father
Frage    ====   question
wie  ====   how
wann     ====   when
Ey   ====   Ey
Willkommen   ====   Welcome
zurück   ====   return
Irrenhaus    ====   Madhouse
War  ====   Was
scheißlangweilig     ====   bored
ohne     ====   without
glotzt   ====   trim
n    ====   n
Freak    ====   Freak
Spastis  ====   Spastic
irgendwem    ====   somebody
erzählt  ====   told
warstauf     ====   warstaking
Schüleraustausch     ====   Student exchange
Frankreich   ====   France
BaguetteVerstecken   ====   Baguette
gespielt     ====   played
Entspann     ====   Relax
Komm     ====   come over
schon    ====   beautiful
Los  ====   Come on
verpasst     ====   lost
Außer    ====   Except
Sache    ====   Thing
mit  ====   with
Erik     ====   Erik
Euch     ====   You
Arsch    ====   ass
vorbei   ====   past
Niemand  ====   No one
unser    ====   our
Sohn     ====   son
Herr     ====   Mr
Obendorf     ====   Obendorf
Uns  ====   US
niemand  ====   nobody
egal     ====   no matter
haben    ====   to have
Leute    ====   people
befragt  ====   interviewed
Auch     ====   Even
Nachbarn     ====   neighbors
Freunde  ====   friends
ganzen   ====   entire
Wald     ====   Forest
durchkämmt   ====   combed
Häuserder    ====   Homes
angrenzenden     ====   adjoining
Bewohner     ====   Resident
durchsucht   ====   search
Beamte   ====   Officer
über     ====   above
Freiwilligesuchen    ====   Volunteer
seit     ====   since
Tagen    ====   Days
eurem    ====   your
tun  ====   to do
unsere   ====   our
Arbeit   ====   job
zwar     ====   though
besser   ====   better
beruhigt     ====   calmed down
Scheißdreck  ====   Shit
tut  ====   does
Hey  ====   Hey
Beruhigt     ====   Calmed down
Halt     ====   Stop
ausschließen     ====   exclude
ob   ====   if
Straftat     ====   Criminal offense
vorliegt     ====   exists
aus  ====   the end
freien   ====   free
Stücken  ====   Stoop
öfter    ====   more often
immernach    ====   always after
Keller   ====   basement, cellar
geschlafen   ====   sleep
oder     ====   or
Es   ====   It
Tage     ====   Day
jetzt    ====   now
finden   ====   Find
euren    ====   go
Kommt    ====   Comes
Hause    ====   Home
Geht     ====   Goes
Franziska    ====   Franziska
Magnus   ====   Magnus
Solltest     ====   Should
drin     ====   in it
Sollte   ====   Should
Schuldirektorineinen     ====   Blame
Joint    ====   joint
Hof  ====   court
rauchen  ====   smoking
schlechtem   ====   poor
Gras     ====   grass
Solche   ====   Such
Versammlungen    ====   Gathering
So   ====   So
abgeschafft  ====   abolished
doch     ====   but
Französisch  ====   French
sonst    ====   otherwise
Eine     ====   One
schöne   ====   lovely
Begrüßung    ====   greeting
habe     ====   have
Morgenvor    ====   Tomorrow
Unterricht   ====   classes
hergebeten   ====   produced
weil     ====   because
euchüber     ====   over
Wichtiges    ====   Important
sprechen     ====   speak
Über     ====   Above
Ihr  ====   you
wisst    ====   knowing
Erikseit     ====   Erikseit
Wochen   ====   Weekly
verschwunden     ====   disappeared
möchte   ====   would like to
Redebedarf   ====   Reflection
Fragen   ====   ask
habt     ====   have
etwasüber    ====   about
Eriks    ====   Eriks
Verschwinden     ====   Disappear
jederzeit    ====   at any time
uns  ====   US
könnt    ====   can
sprecht  ====   talk
an   ====   at
Hierbei  ====   Here
darf     ====   allowed
keine    ====   no
Geheimnisse  ====   Secrets
geben    ====   give
Keiner   ====   None
ihnnach  ====   afterwards
Training     ====   training
gesehen  ====   seen
Luft     ====   air
aufgelöst    ====   dissolved
Will     ====   Want
gefunden     ====   found
werden   ====   will
Geld     ====   money
unterm   ====   under
Bett     ====   bed
Sein     ====   being
Handy    ====   mobile
nimmt    ====   takes
Manchmal     ====   Once in a while
einfach  ====   simple
weg  ====   path
Reifenprofile    ====   Tire profiles
Waldwegvon   ====   Waldweg
Siedlung     ====   settlement
Davon    ====   Of that
LkwSpuren    ====   Traces
Allein   ====   Alone
Region   ====   region
zugelassene  ====   approved
Fahrzeuge    ====   vehicles
alles    ====   All
wir  ====   weather
Vater    ====   father
fährt    ====   moves
einen    ====   a
Transporter  ====   Transporter
verdächtigt  ====   unidentified
abgehauen    ====   escape
Hier     ====   here
Fuchs    ====   Fox
Hase     ====   Hare
gute     ====   quality
Nacht    ====   night
nichtsmit    ====   nothing
meinem   ====   my
Bruder   ====   Brothers
Gar  ====   At all
Deine    ====   Yours
Mutter   ====   mother
heutewieder  ====   today again
Notruf   ====   Emergency call
angerufen    ====   called
Fahr     ====   Driving
Fragst   ====   Ask
falsch   ====   not correct
abgebogen    ====   bent
dein     ====   your
Lebendas     ====   Lively
Gegenteil    ====   opposite
wolltest     ====   wanted
Hotel    ====   hotel
Regina   ====   Regina
Tiedemann    ====   Tiedemann
Apparat  ====   apparatus
verstehe     ====   understand
sicherlich   ====   surely
Kreditrückzahlung    ====   Loan repayment
aussetzen    ====   expose
Beispiel     ====   example
Aufschub     ====   Delay
bis  ====   until
Ganze    ====   Whole
verkalkuliert    ====   corrobious
Hören    ====   Hear
überhaupt    ====   at all
einer    ====   a
Stadt    ====   city
Urlaub   ====   vacation
verschwindet     ====   disappears
Wollen   ====   Want
Hm   ====   Hm
hätte    ====   would have
Familienzimmer   ====   family room
frei     ====   free
Wochenende   ====   weekend
Kleinen  ====   Small
freuen   ====   be happy
Banker   ====   banker
sitzt    ====   sitting
Haufen   ====   heap
Geldund  ====   Money,
schikaniert  ====   harassed
alle     ====   Everyone
aufgebaut    ====   built up
allein   ====   alone
Hilfe    ====   help
Mein     ====   my
ichsind  ====   I am
Jahren   ====   Years
Ihre     ====   Her
Kunden   ====   Customers
Arschloch    ====   asshole
Ihren    ====   Their
Vorgesetzten     ====   Superior
Hallo    ====   Hello
schwarzes    ====   black
Loch     ====   hole
entsteht     ====   arises
Supernova    ====   Supernova
durcheine    ====   by a
zusammenstürzende    ====   interval
Zentralregion    ====   Central region
Neutronenmateriehält     ====   Neutron material preserves
Kollaps  ====   collapse
Weißt    ====   Whisper
frage    ====   question
Ob   ====   If
schwärzeste  ====   blackest
aller    ====   all
Löcherim     ====   Hole
Doppler  ====   Doppler
wohnt    ====   lover
Ernst    ====   serious
wirklich     ====   really
sondern  ====   but
abgemurkst   ====   rubbish
liegt    ====   lies
Dope     ====   Dope
Höhlen   ====   caves
Zeug     ====   things
gelagert     ====   stored
rein     ====   pure
bäm  ====   bem
Bullshit     ====   Bullshit
geil     ====   hot
warst    ====   wicked
mehr     ====   more
Könntest     ====   Could
vorbeischauen    ====   drop by
soll     ====   target
ruf  ====   call
okay     ====   OK
Diesmal  ====   This time
ganz     ====   quite
deutlich     ====   clear
dunkle   ====   dark
Gestaltmit   ====   Shape with
riesigen     ====   huge
Kopf     ====   head
gibt     ====   gives
Dinge    ====   things
dort     ====   there
unserem  ====   ours
kleinen  ====   small
Verstandniemals  ====   Understanding
begreifen    ====   understand
Mads     ====   Mad
geliebt  ====   loved
diesem   ====   This
verschwundenen   ====   missing
deinem   ====   your
damals   ====   back then
wiederholt   ====   repeated
genauso  ====   just like that
passieren    ====   happen
want     ====   want
some     ====   some
I    ====   I
set  ====   set
my   ====   my
sights   ====   sight
on   ====   on
you  ====   you
And  ====   And
no   ====   no
one  ====   one
else     ====   Else
do   ====   do
ve   ====   Ve
got  ====   god
to   ====   to
have     ====   haven
way  ====   way
now  ====   now
baby     ====   infant
All  ====   Alles
know     ====   knowing
is   ====   is
that     ====   that
me   ====   Me
You  ====   You
look     ====   look
like     ====   Like
re   ====   re
having   ====   having
fun  ====   fun
Open     ====   Open
up   ====   up
your     ====   your
loving   ====   loving
arms     ====   arms
Watch    ====   Watch
out  ====   out
here     ====   hand
come     ====   come
spin     ====   spin
right    ====   Right
round    ====   round
Right    ====   Right
Like     ====   Like
a    ====   a
record   ====   recording
Dann     ====   then
läufst   ====   run
rumund   ====   rumund
verkaufst    ====   sold
Scheiß   ====   Shit
Hälfte   ====   half
Markt    ====   market
Kapazitäten  ====   capacities
schafft  ====   creating
zögern   ====   hesitate
dahin    ====   there
holen    ====   to fetch
Shit     ====   shit
Ganz     ====   Quite
easy     ====   Easy
holt     ====   get
welchen  ====   which
Abend    ====   evening
PfadfinderAlarm  ====   Scout
Bartosz  ====   Bartosz
glaubt   ====   believe
Fanny    ====   Fanny
sagt     ====   says
warein   ====   was a
totes    ====   totes
Eichhörnchen     ====   squirrel
fünf     ====   five
Beinen   ====   Legs
echt     ====   real
jeden    ====   every
Nur  ====   Just
nichtüber    ====   no over
Tellerrand   ====   Teller
guckst   ====   look
irgendwas    ====   anything
abgeht   ====   go off
AtomMafianicht   ====   Nuclear
öffentlich   ====   publicly
Atmen    ====   Breathe
vergessen    ====   forget
Stehst   ====   Stand
Alte     ====   Old
s    ====   s
Maul     ====   Mouth
Spasti   ====   Spastic
scheiß   ====   shit
drauf    ====   on it
hin  ====   there
gucken   ====   look at
Hältst   ====   Hold
keinen   ====   none
halben   ====   half
Tag  ====   Day
Unmöglich    ====   Not possible
sterbe   ====   dying
nachher  ====   later
Da   ====   There
glotzen  ====   slip
Fortbildung  ====   Training
zahlen   ====   counting
Hotelzimmer  ====   Hotel room
Ähm  ====   Um
dachte   ====   thought
dachtest     ====   thought
Denk     ====   Think
lang     ====   long
viele    ====   many
Bewerberinnen    ====   Apply
später   ====   later
genau    ====   precisely
total    ====   total
verknotet    ====   knotted
regnen   ====   rain
Narben   ====   scar
spüren   ====   sense
sozusagenin  ====   so-to speak
schauen  ====   look
Gewebe   ====   tissue
verhärtet    ====   hardened
verkrampft   ====   cramped
Ganzeja  ====   Wholeya
Fast     ====   Nearly
Jahrenbin    ====   Youth
gekommen     ====   came
Hätte    ====   Would have
gedacht  ====   thought
Ende     ====   end
seine    ====   his
leid     ====   suffering
Michael  ====   Michael
dir  ====   to you
Jonas    ====   Jonas
Hannah   ====   Hannah
Haus     ====   House
sag  ====   say
Enkel    ====   grandson
Denkst   ====   Think
gewolltDas   ====   intention
krank    ====   ill
also     ====   so
Geh  ====   Go
komm     ====   come over
Mhm  ====   Mhm
Hi   ====   Hi
anderen  ====   others
Zu   ====   to
erklären     ====   explain
SMS  ====   SMS
geschrieben  ====   written
Nicht    ====   not
nie  ====   never
abgeschickt  ====   sentenced
angehört     ====   belound
Sommer   ====   summer
zwischen     ====   between
Ist  ====   is
grad     ====   Degree
D    ====   D
j    ====   j
vu   ====   vu
Licht    ====   light
Als  ====   as
passiert     ====   happened
Fehler   ====   failure
Matrix   ====   matrix
Welt     ====   world
Simulation   ====   simulation
MatrixFehler     ====   Matrix error
Oder     ====   or
Botschaft    ====   message
Jenseits     ====   Beyond
Elternversammlung    ====   Parents' meeting
Heide    ====   pagan
kotzt    ====   puke
Backe    ====   jaw
Ultimate     ====   Ultimate
FistBump     ====   Fistbump
Bring    ====   Bring
sofort   ====   immediately
Entspannt    ====   Relaxed
Baby     ====   infant
Au   ====   Au
Noch     ====   Yet
klar     ====   clear
Na   ====   N / A
vermisst     ====   missing
gilt     ====   is applicable
Klar     ====   Clear
jetzigen     ====   present
Zeitpunktkeine   ====   Timekeeping
neuen    ====   new
Erkenntnisse     ====   findings
ziehen   ====   draw
Betracht     ====   Consideration
eins     ====   one
eurer    ====   your
Hauseirgendetwas     ====   Home millions
erzählen     ====   tell
teilt    ====   Splits
bitte    ====   You're welcome
Charlotte    ====   Charlotte
Miteinanderan    ====   Nose
welche   ====   Which
Maßnahmenfür     ====   Measures
Sicherheit   ====   safety
sorgen   ====   care for
Maßnahmen    ====   measures
ausgehen     ====   go out
Panikmache   ====   Panicmaking
lächerlich   ====   ridiculous
korrigier    ====   corrigible
hatim    ====   has in
Umkreis  ====   Radius
niedrigste   ====   lowest
Straftatenrate   ====   Penitentiary
rennen   ====   run
irgendwelche     ====   any
Mörder   ====   murderer
rum  ====   rum
Statistiken  ====   statistics
abwarten     ====   wait
tot  ====   dead
aufgefunden  ====   founded
Klasse   ====   Great
wem  ====   whom
entführt     ====   abducted
eingesperrt  ====   locked up
Laber    ====   Laborer
istund   ====   is and
rauskann     ====   rauskan
jemandJemand     ====   somebody
einsperren   ====   lock up
Hänsel   ====   Haunder
Gretel   ====   Gretch
Hexe     ====   witch
essen    ====   eat
meisten  ====   most
nett     ====   kind
Manche   ====   Some
trotzdemdas  ====   anyway
deine    ====   yours
Schwester    ====   sister
ey   ====   Ey
Laut     ====   According to
Böseeine     ====   Meal
Perspektive  ====   perspective
Toter    ====   Dead
schlechtes   ====   bad
Thema    ====   topic
lebtWenn     ====   wearing
findet   ====   find
fände    ====   fountain
Schlimmste   ====   Worst
Selbst   ====   Self
Können   ====   Can
wechseln     ====   switch
Wichtig  ====   Important
zusammenhalten   ====   hold together
Strang   ====   strand
hochkochen   ====   cook
Presse   ====   Press
passt    ====   fits
Um   ====   Around
Hotelgeht    ====   Hotel
gar  ====   at all
Ach  ====   Oh
nein     ====   no
worum    ====   what
Falsch   ====   Not correct
hierum   ====   here, at
verschwundenes   ====   disappearance
gerade   ====   just
Kümmer   ====   Carer
einfachum    ====   simply
eigenen  ====   own
Probleme     ====   Problems
Ahnung   ====   idea
wovon    ====   About what
redest   ====   talk
Helge    ====   Helical
machst   ====   make
bring    ====   bring
Mir  ====   Me
langweilig   ====   boring
gleich   ====   same
vorne    ====   in front
Sessel   ====   chair
Fuck     ====   Fuck
Sucht    ====   Seeks
meiner   ====   mine
Definition   ====   definition
Besitz   ====   possession
Herrschaft   ====   Rule
Person   ====   person
verkaufe     ====   sell
gibst    ====   give
dafür    ====   Therefore
nen  ====   nine
Arschtritt   ====   Ass
locker   ====   relaxed
wert     ====   value
Für  ====   For
wechselt     ====   switch
Besitzer     ====   owner
Papi     ====   Papi
Hör  ====   Hear
quatschen    ====   chat
Gib  ====   Give
Beutel   ====   bag
Jackpot  ====   jackpot
jemand   ====   someone
Scheißlampen     ====   Shit lamps
Lauft    ====   Runs
What     ====   Whate
the  ====   The
fuck     ====   fuck
Keine    ====   No
Wieso    ====   how come
Habt     ====   Have
Spur     ====   track
schläft  ====   is sleeping
Gott     ====   God
gib  ====   give
Gelassenheit     ====   serenity
Unabänderliches  ====   Unalterable
hinzunehmen  ====   accept
Mut  ====   courage
Veränderliches   ====   Varying
ändern   ====   change
Weisheit     ====   wisdom
beides   ====   both
unterscheiden    ====   differentiate
Einheiten    ====   units
Waldrand     ====   Forest
Neuweiher    ====   Neo
Höhe     ====   height
F    ====   F
Kilometer    ====   kilometre
vier     ====   four
Kinderleiche     ====   Nickel
NETFLIX  ====   Netflix
PRÄSENTIERT  ====   PRESENTS
EINE     ====   ONE
ORIGINAL     ====   ORIGINAL
SERIE    ====   SERIES
Opfer    ====   victim
männlich     ====   masculine
Zeitpunkt    ====   time
Todes    ====   Death
etwa     ====   approximately
Stunden  ====   hours
Diese    ====   These
Verbrennung  ====   combustion
Augenist     ====   Eye
eigenartig   ====   strange
geschmolzen  ====   melted
Anzeichen    ====   Sign
sexuellem    ====   sexual
Missbrauch   ====   abuse
Kein     ====   No
Sperma   ====   sperm
fremde   ====   stranger
DNA  ====   DNA
seltsam  ====   strange
Schau    ====   look
Neben    ====   Next to
Verbrennungensind    ====   Combustion
Gehörgänge   ====   Hearing
zerstört     ====   destroyed
Innenohr     ====   Inner ear
völlig   ====   fully
lädiert  ====   damaged
Beide    ====   Both
Trommelfelle     ====   Drum
geplatzt     ====   burst
Extreme  ====   Extreme
Lautstärke   ====   volume
Druck    ====   pressure
ausgelöst    ====   triggered
durch    ====   by
Sturzflug    ====   Dive
heftige  ====   fierce
Rotationen   ====   Rotation
Zentrifuge   ====   centrifuge
Otokonien    ====   Otoconium
Steinchen    ====   Stone
Gehörgängen  ====   Belonging
Durch    ====   By
wissen   ====   to know
wo   ====   Where
oben     ====   above
unten    ====   below
Rotation     ====   rotation
verirren     ====   get lost
verlieren    ====   lose
Gleichgewicht    ====   balance
Jungen   ====   Boys
hingehört    ====   believed
gemachtAu    ====   macaway
bescheuert   ====   stupid
geredet  ====   talked
Drogen   ====   Drugs
erneutein    ====   again a
Junge    ====   Young
spurlos  ====   traceless
Nach     ====   To
Angaben  ====   declarations
Polizeiwurde     ====   Police
Jährige  ====   Year-old
zuletzt  ====   last
seinen   ====   his
Geschwisternim   ====   Siblings
Windener     ====   Windener
Forst    ====   Forest
nahe     ====   vicinity
Kraftwerksund    ====   Power plant and
Polizei  ====   police
bittet   ====   ask
Hinweise     ====   Hints
Aufklärung   ====   enlightenment
helfen   ====   help
Bürgervereine    ====   Civil marrow
organisieren     ====   to organize
Absprachemit     ====   Consultation with
lokalen  ====   local
Behörden     ====   Authorities
Suchaktionen     ====   Searchbooks
Seit     ====   Since
Jährigeraus  ====   Year-old
Fälle    ====   cases
zusammenhängen   ====   contour
Polizeiderzeit   ====   Polish time
unkommentiert    ====   unassigned
lassen   ====   permit
wahrscheinlich   ====   probably
unterwegs    ====   On the way
Wegen    ====   Because
Sollen   ====   Should
Ruf  ====   call
abhörst  ====   bother
große    ====   size
Sorgen   ====   Care for
hoffe    ====   hope
konnte   ====   could
erreichen    ====   reach
Kindern  ====   Children
mehrere  ====   several
Suchtrupps   ====   Search troops
organisiert  ====   organized
letzte   ====   last
aufgewacht   ====   woke up
gegen    ====   against
Mitternacht  ====   midnight
schlafen     ====   sleep
Bin  ====   Am
Gartenund    ====   Gardenund
Büsche   ====   Bushes
winterfest   ====   winter
Auto     ====   automobile
Schnur   ====   line
musste   ====   had to
kurz     ====   short
Tankstelle   ====   Gas station
Erst     ====   First
Papas    ====   Papas
verschwand   ====   disappear
alt  ====   old
drei     ====   three
Jahre    ====   years
jünger   ====   younger
Man  ====   One
sagte    ====   said
schlimmsten  ====   worst
kommt    ====   comes
bestimmt     ====   certainly
Nachrichten  ====   news
Ton  ====   volume
ähm  ====   um
Tschüss  ====   bye
Tote     ====   dead
weder    ====   neither
Mikkelnoch   ====   Chick
Er   ====   He
entstellt    ====   disfigured
Augenpartie  ====   Eye part
verbrannt    ====   burnt
An   ====   At
seiner   ====   his
Kleidung     ====   clothing
überall  ====   all over
rote     ====   Red
Erde     ====   Earth
Fundstelle   ====   Site
Außerdem     ====   aside from that
Jungenin     ====   Boy
Sachen   ====   Things
ern  ====   nerve
gekleidet    ====   dressed
Schuhe   ====   shoes
Walkman  ====   Walkman
Hals     ====   throat
Kordel   ====   cord
Pfennigaus   ====   Penny
Auf  ====   on
Kassette     ====   cassette
ErikWöller   ====   Erikwöller
koordiniert  ====   coordinated
Suche    ====   seek
nichtsüber   ====   nothing
Fund     ====   Fund
Leiche   ====   corpse
raus     ====   Out
verschwundene    ====   disappeared
Kinderund    ====   Kids and
toten    ====   kill
Kontaktiert  ====   Contacted
Vermisstenstelle     ====   Missing agency
Befragt  ====   Interviewed
Jeden    ====   Every
Höhle    ====   cave
Tür  ====   door
führt    ====   leads
aufs     ====   onto
AKWGelände   ====   Akle
brauchen     ====   to need
Durchsuchungsbefehl  ====   Looking forward
Gelände  ====   terrain
Hochsicherheitsbereich   ====   High-security area
Zaun     ====   fence
Den  ====   The
Draht    ====   wire
abgelaufen   ====   expired
Nirgends     ====   Nowhere
beschädigte  ====   damaged
Stelle   ====   Job
zusammenhängt    ====   closes
tote     ====   dead
hattest  ====   had
recht    ====   Law
neben    ====   Next
stimmt   ====   Right
beantrage    ====   request
bald     ====   soon
verschwinden     ====   disappear
Jürgen   ====   Jürgen
rumschnüffeln    ====   snoop around
besserjemand     ====   battle
anders   ====   different
erpresst     ====   erupt
Erfolgreichevon  ====   Success
Erfolglosen  ====   Unsuccessful
unterscheidet    ====   differs
Eben     ====   Just
niemandem    ====   no one
Verstanden   ====   Understood
Kann     ====   Can
Ihnen    ====   them
behilflich   ====   assistant
brauche  ====   need
Zimmer   ====   room
Muss     ====   Got to
schrecklich  ====   dreadful
Aleksander   ====   Aleksander
blockierteden    ====   blocked
Erlass   ====   Adoption
Richter  ====   judge
hörst    ====   hear
Ah   ====   Ah
zumindest    ====   at least
theoretisch  ====   theoretically
Gravitationsanomalie     ====   Gravitational anomaly
Biegen   ====   To bend
Raum     ====   space
möglich  ====   possible
Werden   ====   Will
je   ====   ever
Lage     ====   location
reisen   ====   travel
dahinterliegt    ====   behind
Welchen  ====   Which
Preis    ====   price
würden   ====   would
bezahlen     ====   pay
weit     ====   far
würde    ====   would
Wissenschaft     ====   science
mach     ====   make up
Tor  ====   gate
Lass     ====   let
Hang     ====   hillside
absuchen     ====   search
Euren    ====   Go
Teil     ====   part
Bitte    ====   You're welcome
niemanden    ====   no one
reinlassen   ====   pure
Hochsicherheitstrakt     ====   High-security tract
Meine    ====   My
patrouillieren   ====   patrol
Wäre     ====   Were
wüssten  ====   knew
Willst   ====   Want
fertigmachen     ====   get ready
wirst    ====   become
dudieses     ====   dudies
verschissene     ====   shaped
aufmachen    ====   open up
Mach     ====   Make up
Tut  ====   Does
Wirklich     ====   For real
Mensch   ====   person
sehen    ====   see
Wisst    ====   Knowing
PKW  ====   Car
unbestimmt   ====   indefinitely
Zuordnung    ====   Assignment
Kleintransporter     ====   Small transporter
Jankowski    ====   Jankowski
Akten    ====   File
hatte    ====   would have
Zeitpunktvon     ====   Timeby
Schicht  ====   layer
arbeitet     ====   is working
daals    ====   dals
Lagerarbeiter    ====   Warehouse worker
Fahrer   ====   driver
überprüftNatürlich   ====   Naturally checked
Zugang   ====   access
denke    ====   think
gestern  ====   yesterday
gesprochen   ====   spoken
fallen   ====   fall
gesagt   ====   said
deins    ====   yours
zusammen     ====   together
verkauft     ====   sold
Warst    ====   Wicked
wieso    ====   how come
ihren    ====   their
Schrott  ====   scrap metal
herbringen   ====   bring up
findest  ====   find
Mofa     ====   moped
gespart  ====   saved up
Meinst   ====   Mean
Glaubst  ====   Believe
Geheimnis    ====   secret
Nee  ====   No
Vermisst     ====   Missing
vermisse     ====   miss
Vorstellung  ====   performance
ihm  ====   him
Eigentlich   ====   actually
wer  ====   who
irgendjemand     ====   anyone
sagst    ====   tell
Wahrheit     ====   truth
lügst    ====   laughing
Egal     ====   All the same
[Choralartiger   ====   [Choral-like
polyphoner   ====   polyphoner
Gesangsetzt  ====   Abandoned
]    ====   ]
wohne    ====   live
Wurzeln  ====   root
schlagenDu   ====   punch
Spinner  ====   crackhead
falschen     ====   false
Schwer   ====   Heavy
Kapee    ====   Cape
wohnst   ====   live
Tod  ====   death
Sieht    ====   Sees
duWo     ====   you where
Eltern   ====   parents
SieWeißt     ====   She knows
MadsSie  ====   Madsie
weh  ====   sore
Nun  ====   so
Wann     ====   When
Ines     ====   Ines
Nachtschicht     ====   Night shift
Frau     ====   Mrs
Schüttlers   ====   Shaker
Tochter  ====   daughter
Benni    ====   Benni
fahren   ====   travel
Familie  ====   family
Problem  ====   problem
Sag  ====   say
Dr   ====   Dr
Reimann  ====   Reimer
Verschlossen     ====   Locked
versiegelt   ====   sealed
[Rhythmischer    ====   [Rhythmic
AcappellaGesangläuft     ====   AcAPPELLAGES
weiter   ====   Further
November     ====   November
eines    ====   one
Jährigenin   ====   Year-old
Stimmen  ====   voices
Ermittlerimmer   ====   Investigator
lauter   ====   volume up
Fall     ====   case
wirft    ====   throws
einige   ====   some
Rätsel   ====   mystery
Trotz    ====   Despite
weitflächiger    ====   wide-scale
einzigeverwertbare   ====   The only usable
Mithilfe     ====   Help
Brand    ====   fire
Chemiekonzern    ====   Chemical company
spitzt   ====   tipsy
Rhein    ====   Rhine
Giftstoffe   ====   Toxins
nachgewiesen     ====   proven
Gerade   ====   Just
Zeiten   ====   Time
diesen   ====   this
Ängsten  ====   Fear
stellen  ====   place
Denn     ====   Because
Mutigen  ====   Brave
Zweiflern    ====   Doubles
Gestrigen    ====   Yesterday
aussiehst    ====   looks
kannst   ====   can
mache    ====   make
Fechtunterricht  ====   Fencing
bezahlt  ====   paid
kämmst   ====   combat
Haare    ====   hair
Schluck  ====   Swallow
Wasserin     ====   Water
Kurve    ====   Curve
rede     ====   speech
lasse    ====   laser
versauen     ====   mess up
Entschluss   ====   decision
Position     ====   position
erstmalseiner    ====   first
anzuvertrauen    ====   entrust
super    ====   Super
gehtNein     ====   go
Mädchen  ====   girl
verschleppt  ====   carried off
wegen    ====   because
ihres    ====   Yours
roten    ====   redden
Lippenstifts     ====   Lipstick
bringt   ====   brings
Heftig   ====   Violent
Lippenstift  ====   lipstick
Nutten   ====   Hook
finde    ====   find
Nino     ====   Nino
de   ====   de
Angelobesser     ====   Fishermesser
Falco    ====   Falco
sei  ====   may be
gemein   ====   mean
soWarst  ====   sow
neu  ====   New
suche    ====   seek
Kindergarten     ====   kindergarten
Direktorin   ====   Director
Hubert   ====   Hubert
ne   ====   ne
Schwuchtel   ====   Habit
jung     ====   young
Acid     ====   acid
Claudia  ====   Claudia
ChefinJa     ====   Chief
Vorstand     ====   board of directors
stimmte  ====   voted
einstimmig   ====   unanimously
Glückwunsch  ====   congratulation
wusste   ====   knew
Geschenk     ====   gift
Buch     ====   a book
dran     ====   your turn
stehen   ====   stand
hinter   ====   Behind
Clau     ====   Clay
KEINE    ====   NO
ZUKUNFT  ====   FUTURE
Kurz     ====   Short
sechs    ====   six
ichsie   ====   I her
füttern  ====   feed
Wolf     ====   wolf
Bissspuren   ====   Show tracks
Vergiftet    ====   Poisoned
sprangen     ====   jump
gab  ====   gave
früher   ====   previously
tötet    ====   killing
Schafe   ====   Sheep
Sehet    ====   See
wachet   ====   guard
betet    ====   praying
kommet   ====   comet
Markusevangelium     ====   Jump Gospel
Wusste   ====   Knew
gläubig  ====   believer
Pfarrer  ====   Pastor
Guter    ====   Goods
Tronte   ====   Trit
Nielsen  ====   Nielsen
Tagesanzeiger    ====   Daylight
Interview    ====   interview
Werte    ====   values
wollten  ====   wanted to
ranzukommen  ====   comment
Herzlichen   ====   Cordial
Unglaublich  ====   Incredible
Chefin   ====   boss
Sind     ====   Are
richtigen    ====   right
Zahlen   ====   Counting
hierIch  ====   Here me
Arbeitet     ====   Is working
hierNein     ====   herein
WitzIst  ====   Wit
Ulrichs  ====   Ulrich
Mist     ====   Damn
gewachsen    ====   grown
Hat  ====   Has
duMikkel     ====   dummy
WeiterNielsen    ====   Farmer
heißen   ====   mean
bringe   ====   bring
heim     ====   home
Welcher  ====   Which
Welches  ====   Which
verletzten   ====   injured
Gleich   ====   Same
abund    ====   abund
kümmert  ====   takes care
kümmere  ====   caress
michin   ====   me in
wehtun   ====   hurt
verspreche   ====   promising
interessiert     ====   Interested
Kernkraftwerk    ====   Nuclear power plant
leitet   ====   lead
selbst   ====   self
progressiv   ====   progressive
Sekretärineinen  ====   Secretary
Termin   ====   meeting
geklärt  ====   clarified
hängen   ====   hang
fällt    ====   fall
Decke    ====   ceiling
Jana     ====   Jana
dreht    ====   turn
Heute    ====   today
Anschluss    ====   connection
unter    ====   under
dieser   ====   this
Nummer   ====   number
rufen    ====   call
Auskunft     ====   information desk
ins  ====   into the
Krankenhaus  ====   hospital
Arm  ====   poor
Danach   ====   Thereafter
wollen   ====   want
My   ====   My
only     ====   just
aim  ====   aim
take     ====   Take
many     ====   many
lives    ====   lives
The  ====   The
more     ====   More
better   ====   pretty
feel     ====   feel
geschickt    ====   sent
Findest  ====   Find
lustig   ====   fun
JungeDamit   ====   Jungedamite
Haben    ====   Have
gesoffenWie  ====   sound
gesoffenFür  ====   fold
wen  ====   whom
hältst   ====   hold
dasEin   ====   to be there
Huf  ====   hoof
sieht    ====   sees
WieseWelche  ====   Meadow
Wiese    ====   Meadow
getötetWenn  ====   wenny
saufen   ====   drink
würdest  ====   thought
wäre     ====   were
offen    ====   open minded
Schlüssel    ====   key
dirden   ====   Dirty
neusten  ====   latest
Ermittlungsstand     ====   Investigation
mitteilen    ====   communicate
neue     ====   new
Jetzt    ====   now
verpissen    ====   piss
funktioniert     ====   functions
Deinen   ====   Yours
Namen    ====   Name
verraten     ====   betray
Verband  ====   Association
weinen   ====   cry
Bernd    ====   Bernd
Wolltest     ====   Wanted
unterjubelnIch   ====   undercut
fragte   ====   asked
Leichen  ====   corpses
manche   ====   some
ohnehin  ====   anyway
Meldewerten  ====   Signaling
Überall  ====   All over
Monaten  ====   Monthly
Tschernobyl  ====   Chernobyl
verändert    ====   changes
Vertrauenin  ====   Trust in
Kernenergie  ====   Nuclear energy
verloren     ====   lost
sahen    ====   saw
Bilder   ====   pictures
Angst    ====   anxiety
istder   ====   is the
schlimmste   ====   worst
Feind    ====   enemy
Fortschritts     ====   Progress
Gegendleben  ====   Counterfeit
Angestellte  ====   employee
exklusive    ====   exclusive
Posten   ====   Post
antrittst    ====   antrite
trägst   ====   wear
nurdie   ====   only
Verantwortung    ====   responsibility
Verantwortungfür     ====   Responsibility for
getäuscht    ====   deceived
sollte   ====   should
bedeutet     ====   means
UndBei   ====   And in
grünen   ====   green
Bereich  ====   area
grün     ====   green
großes   ====   big
Ding     ====   thing
Leitung  ====   management
EnkelinRegina    ====   Grandinian
vergiftet    ====   poisoned
worden   ====   has been
Kaum     ====   Barely
deutet   ====   indicated
plötzlichen  ====   sudden
Herztod  ====   Herztod
typisch  ====   typical
echte    ====   true
Sensibelchen     ====   Sensitive
Panik    ====   panic
geraten  ====   devices
steigert     ====   enhanced
Herde    ====   herd
Teufelskreis     ====   Vicious circle
Fliegen  ====   To fly
auslösenAlles    ====   trigger
Mögliche     ====   Possible
MenschEin    ====   Man
einzelner    ====   single
Freddy   ====   Freddy
Krueger  ====   Krueger
anstrengen   ====   exert
Hatte    ====   Would have
Schafen  ====   sleep
Fehlte   ====   Missing
schuf    ====   shrew
Kennst   ====   Know
Satanisten   ====   Satanists
Soweit   ====   So far
Brimborium   ====   Brimborium
draus    ====   out
Spuren   ====   traces
Seltsam  ====   Strange
beiden   ====   both
Seiten   ====   pages
unserer  ====   our
PartyMeine   ====   Partyme
Hackfleischdinger    ====   Minced meat
Sauscharf    ====   Ruffle
saulecker    ====   sauce
Tropfen  ====   drops
Ozean    ====   ocean
hierbleiben  ====   stay here
lesen    ====   read
komme    ====   come
Pizza    ====   Pizza
erledigen    ====   complete
ApokalypseHm     ====   Apocalype
Schon    ====   Nice
enttäuschend     ====   disappointing
mirirgendwie     ====   miral
vorgestellt  ====   presented
Greller  ====   Greater
ausgelöscht  ====   extinguished
wirdund  ====   becoming
beginnt  ====   begins
wünschen     ====   wish
nächsten     ====   next
Mal  ====   Times
MikkelSchwarze   ====   Mikkel black
Löcher   ====   Holes
gelten   ====   are valid
dieHöllenschlunde    ====   dihöllenlunde
Universums   ====   Universal
hineinfällt  ====   fall in
wohin    ====   where
schwarzen    ====   black
denDingen    ====   Dendingen
wären    ====   be
Kreismiteinander     ====   Circle
ausder   ====   from the
beeinflusst  ====   influenced
Tick     ====   Tick
tack     ====   tack
kleine   ====   small
hinterhältige    ====   sneaky
Fotze    ====   cunt
Elli     ====   Elli
Praxisnoch   ====   Practical
Heim     ====   home
Elisabeth    ====   Elisabeth
blöde    ====   stupid
Kuh  ====   cow
roter    ====   red
blödenLippenstift    ====   stupid lipstick
acht     ====   eight
Ichbenutze   ====   I use
verarschen   ====   fool
Kulleraugen  ====   Leaflet
unddeiner    ====   and your
TaubstummenMitleidsnummer    ====   Deaf-ment mtsleidnumber
verarschst   ====   stubborn
fertig   ====   done
fahre    ====   drive
Soll     ====   Intended to
mitnehmen    ====   take along
Wei  ====   White
t    ====   t
Polizeiarbeit    ====   Police work
mag  ====   like
Angeber  ====   Punch
Idiot    ====   idiot
ober     ====   top
zurückkommt  ====   returns
dunicht  ====   not you
anrufen  ====   call
Schönes  ====   Beautiful
ständig  ====   constant
abhauen  ====   abbey
Wem  ====   Whom
aufhören     ====   stop
Sei  ====   May be
traurig  ====   Sad
Vor  ====   before
Jähriger     ====   Year-old
aufmysteriöse    ====   mysterious
Art  ====   Kind
alarmiert    ====   alarmed
weitererVermisstenfall   ====   Further insurance
Bürger   ====   citizens
jährige  ====   year-old
giltseit     ====   guy
Sachdienliche    ====   Relevant
Hinweisenimmt    ====   Summarize
entgegen     ====   opposite
kam  ====   came
Monatenvermehrt  ====   For months
Stromausfällen   ====   Power outages
undöffentliche   ====   and public
Einrichtungen    ====   Facilities
bislang  ====   so far
beeinträchtigt   ====   impaired
Betreiber    ====   operator
derStromnetze    ====   grid
versichern   ====   assure
Ursache  ====   root cause
Grund    ====   reason
bitten   ====   ask
weitere  ====   Further
Vorfälle     ====   Incidents
melden   ====   Report
beschlagnahmt    ====   confiscated
grossr   ====   great
Unterschied  ====   difference
nennst   ====   call
bleibt   ====   remain
Gleiche  ====   Same
hole     ====   go
duauf    ====   you on
wartest  ====   wait
abholst  ====   pick up
Yasin    ====   Yasin
Boyfriend    ====   Boyfriend
dazu     ====   to
Roman    ====   novel
durchzieht   ====   run through
Netzvon  ====   Grid
Symbolen     ====   Symbols
Verweisen    ====   Refer
Beispiele    ====   Examples
Fülle    ====   Abundance
Symboleseien     ====   Symbol
Platanen     ====   Plane
See  ====   lake
genannt  ====   called
Spezialfall  ====   Special case
derWiederholungen    ====   repeat
Goethe   ====   Goethe
Figuren  ====   characters
folgenteils  ====   subsequent
bewusst  ====   consciously
weitermachen     ====   keep going
Symmetrie    ====   symmetry
einespezielle    ====   one-purpose
Doppelung    ====   Double
Achse    ====   axis
spiegeltsich     ====   mirror
Wiederholte  ====   Repeated
Wiederholung     ====   repetition
voneiner     ====   one
imaginären   ====   imaginary
Mitte    ====   center
weist    ====   point
Richtungen   ====   Directions
etlichen     ====   quite
Stellen  ====   Place
verweist     ====   refers to
Romanauf     ====   Novel
stattfindende    ====   taking place
Ereignisse   ====   events
Ottilies     ====   Ottilies
Hungertod    ====   Hungry
dritten  ====   third
Kapitel  ====   chapter
vonTeil  ====   abide
vorbereitet  ====   prepared
ihre     ====   their
Mä   ====   Mä
igkeit   ====   ivancy
Essenund     ====   Eat and
Trinken  ====   To drink
hingewiesen  ====   point out
Dieser   ====   This
Hinweis  ====   Note
wirdsogar    ====   becoming
müsste   ====   might
Toilette     ====   Toilet
Ornithologe  ====   ornithologist
weissn   ====   white
Flecken  ====   stains
imGefieder   ====   imaginary
untypisch    ====   atypical
umgebracht   ====   killed
Gibt     ====   Gives
Neues    ====   New
Erdboden     ====   ground
verschluckt  ====   swallowed
VermisstenDatenbankabgeglichen   ====   Missing database
Treffer  ====   Hits
Gefiederhabe     ====   Feather
Vögel    ====   Birds
Irgendwie    ====   Somehow
alleszusammen    ====   alltogether
wei  ====   white
ganzenMorgen     ====   whole morning
klingeln     ====   ring
Telefone     ====   Telephones
Jemand   ====   Someone
dentoten     ====   the dead
antworten    ====   answers
geh  ====   go
durchdie     ====   through the
VermisstenDatenbank  ====   Missing database
nimm     ====   take
ältere   ====   older
Anzeigen     ====   To sue
Womöglich    ====   Possibly
berprüf  ====   professional
Sonst    ====   Otherwise
hm   ====   Hm
Doch     ====   Indeed
näheren  ====   see
Fundort  ====   Location
Tatort   ====   crime scene
stammen  ====   come
darum    ====   therefore
kümmern  ====   To take care of
wirwegen     ====   we are
immernoch    ====   still
fast     ====   nearly
Reifenprofilengucken     ====   Tire profile
Reifen   ====   tires
Waldstrass   ====   Forest
AmTag    ====   During the day
abnehmen     ====   decrease
Von  ====   from
Wildwechselkamera    ====   Wild change camera
vielleichtsieht  ====   virtually
Datenbank    ====   Database
fragst   ====   ask
dannnach     ====   then
Reifenprofilen   ====   Tire profiles
Am   ====   At the
Mikkelverschwand     ====   Mikkelverschwand
Anruf    ====   Call
Abwesenheit  ====   absence
gefragt  ====   asked
Bescheidgeben    ====   Confirm
heimkomme    ====   home
Besonderes   ====   Special
Montag   ====   Monday
dieganze     ====   the whole
Praxis   ====   practice
Protokolle   ====   Protocols
Denganzen    ====   The whole
ungefähr     ====   approximately
wasin    ====   Wasin
schicken     ====   send
totalvergessen   ====   totally forgotten
angekommen   ====   arrived
obPeter  ====   obstacle
Kunde    ====   customer
Diesen   ====   This
denDienstausweis     ====   Continuous
privateFrage     ====   privacy
berufliche   ====   professional
Macht    ====   Power
nötig    ====   necessary
astreinesGedächtnis  ====   astreise
Schwänze     ====   Dick
Peters   ====   Peters
leicht   ====   easy
krummwie     ====   crooked
eingelegte   ====   pickled
Gurke    ====   cucumber
Komisches    ====   odd one
Gefühl   ====   feeling
Mund     ====   mouth
Kennen   ====   Know
übereinem    ====   over
woandershin  ====   elsewhere
Anfang   ====   Beginning
Hausegelassen    ====   Housekeeping
sollen   ====   should
eineLeiche   ====   a corpse
einenFreund  ====   a friend
Pathologie   ====   pathology
istganz  ====   is whole
grausam  ====   awful
verstümmelt  ====   mutilated
fest     ====   fixed
Vogel    ====   bird
Geplatzte    ====   Burst
Trommelfelleauf  ====   Drum pole
daran    ====   to it
gestorben    ====   died
wohl     ====   well
Orientierung     ====   orientation
verlorenund  ====   lost
Boden    ====   floor
geknallt     ====   bounded
Gebrochener  ====   Broken
Schädel  ====   skull
Elektromagnetische   ====   Electromagnetic
Felderstören     ====   Field
sensorische  ====   sensory
System   ====   system
Hochspannungsmasten  ====   High voltage masts
Spannungen   ====   Tension
Radiowellenbereich   ====   Radio wave range
Eher     ====   Rather
Elektrogeräte    ====   Electrical appliances
weiss    ====   White
Maserung     ====   Grain
Gefieder     ====   plumage
dieöfter     ====   dairy
Form     ====   shape
Mutation     ====   mutation
verstrahlt   ====   radiating
Habe     ====   Have
nachgemessen     ====   measured
Interessant  ====   Interesting
laut     ====   according to
Schneckenweibchen    ====   Female
beissnden    ====   beyond
Männchen     ====   male
Pimmel   ====   willie
ausgedacht   ====   thoughtful
kriechen     ====   to crawl
dannals  ====   then as
Weibchen     ====   female
Witz     ====   joke
Woher    ====   Where
Aus  ====   the end
Fernsehen    ====   TV
Oma  ====   granny
wartet   ====   waits
schnell  ====   fast
Moment   ====   moment
Polizeichefin    ====   Polish
Schei    ====   Shit
Spack    ====   Mock
woher    ====   where
viel     ====   much
Vertickst    ====   Vertexed
dudeshalb    ====   dude
verdiene     ====   deserve
damit    ====   in order to
Raus     ====   Out
ausdiesem    ====   diffuse
schei    ====   shit
verlogenen   ====   mendacious
Vorne    ====   In front
freundliches     ====   friendly
Lächeln  ====   smile
lügen    ====   lying
Spielst  ====   Play
brave    ====   brave
EinserSchülerin  ====   Noise
schlafenseit     ====   Sleep
getrennt     ====   separated
fand     ====   found
dassmein     ====   that my
steht    ====   stands
Ehe  ====   before
kaputt   ====   broken
Dafür    ====   Therefore
einfettes    ====   scrap
Tisch    ====   table
isst     ====   eat
Brötchenund  ====   Bread roll
selbstgemachten  ====   homemade
Marmelade    ====   jam
dicker   ====   thicker
fetter   ====   fetter
Platz    ====   place
gibtzwischen     ====   gossip
Wänden   ====   Walls
atmen    ====   breathe
Hol  ====   Hold
derSchule    ====   the school
schaff   ====   schaff
Patienten    ====   Patient
Siekann  ====   She can
warten   ====   wait
Warte    ====   Wait
hastdu   ====   do you have
versprochen  ====   promised
irgendetwas  ====   anything
wasdu    ====   what you
Entschuldigung   ====   Excuse me
abholen  ====   pick up
abgeholt     ====   picked up
Clemens  ====   Clemens
Eswar    ====   It was
Uhr  ====   clock
Bescheid     ====   notice
gegeben  ====   given
Hausaufgabenheft     ====   Homework
Sicherheitsleute     ====   Security people
fanden   ====   found
aufdem   ====   on the
geklettert   ====   climbed
sehrkooperativ   ====   non-cooperative
gezeigt  ====   shown
froh     ====   joyful
dassAleksander   ====   thataleksander
Anzeige  ====   advertisement
Jeder    ====   Everyone
Verständnis  ====   understanding
fürdeine     ====   for your
klettern     ====   climb
danke    ====   thanks
reicht   ====   enough
verstehst    ====   understand
dudas    ====   you the
irgendeine   ====   any
Akte     ====   file
Beispielsein     ====   Example
Strafe   ====   penalty
Steckdir     ====   Plug
DurchsuchungsbefehlWarum     ====   Search wastewater
keiner   ====   none
Weildas  ====   Because that
aussteigen   ====   exit
stand    ====   was standing
Waldweg  ====   Forest road
abgefahren   ====   worn
zweimal  ====   twice
miteinem     ====   with a
Klassenliste     ====   Class list
Minuten  ====   Minute
ganzeKlassenliste    ====   complete customer list