AKWs====Nuclear power plants
Abend====Eve
Aber====But
Ach====Oh
Ahnung====idea
Alarm====alarm
All====Alles
Alle====All
Allein====Alone
Allerdings====Indeed
Alles====Everything
Als====As
Also====So
Alte====Old
And====And
Apokalypse====Apocalypse
Apparat====apparatus
Applaus====applause
Arbeit====job
Arbeitskleidung====Workwear
Arsch====ass
Arschloch====asshole
Arschtritt====Ass kick
Atmen====To breathe
Atom====atom
Atomausstiegs====Nuclear phase-out
Atomgesetz====Atomic Act
Au====Au
Aua====Ouch
Auch====Also
Aufatmen====Take a deep breath
Aufschub====Postponement
Augenblick====moment
Außer====Except
Baby====infant
Backe====jaw
Baguette====baguette
Banker====banker
Bartosz====Bartosz
Bau====construction
Beamte====Officer
Begrüßung====greeting
Beinen====Legs
Beispiel====example
Bericht====report
Beruhigt====Calmed down
Besitz====possession
Besitzer====owner
Betracht====Consideration
Bett====bed
Beutel====bag
Bewerberinnen====Applicants
Bewohner====Residents
Bis====To
Bist====Are
Botschaft====Embassy
Bring====Bring
Bruder====Brothers
Bullshit====Bullshit
Bump====Bump
Bury====Bury
Bäcker====baker
Böse====Angry
Charlotte====Charlotte
Da====There
Damit====In order to
Danke====thanks
Dann====Then
Das====The
Dass====That
Davon====From that
Definition====definition
Dein====Your
Deine====Yours
Denk====Think
Denkst====You think
Der====The
Die====The
Diesmal====This time
Dinge====Things
Don====Don
Donnern====thunder
Dope====Dope
Doppler====Doppler
Dröhnen====Roar
Du====You
Eichhörnchen====squirrel
Ein====A
Eine====A
Einen====One
Einheiten====units
Elternversammlung====Parents meeting
Ende====end
Enkel====grandson
Entspann====Relax
Entspannt====Relaxed
Er====He
Erik====Erik
Eriks====Eriks
Erkenntnisse====findings
Ernst====serious
Errichtung====Establishment
Erster====First
Erwacht====Awakened
Es====It
Essen====eat
Euch====To you
Ey====Ey
Fahr====Drive
Fahrzeuge====vehicles
Falsch====Not correct
Familienzimmer====family room
Fanny====Fanny
Fast====Nearly
Fehler====error
Feuerrädern====Fire wheels
Fist====Fist
For====For
Fortbildung====Advanced training
Frage====question
Fragen====ask
Fragst====Ask
Frankreich====France
Franziska====Franziska
Französisch====French
Frau====Mrs
Freak====Freak
Freiwillige====Volunteers
Freunde====Friends
Frühstück====breakfast
Fuchs====Fox
Fuck====Fuck
Funk====Wireless
Für====For
Ganz====All
Ganze====Whole
Gar====At all
Gegenteil====opposite
Gegenwart====presence
Geh====Go
Geheimnisse====Secrets
Geht====Go
Gelassenheit====serenity
Geld====money
Genau====Exactly
Geräte====equipment
Gesang====singing
Geschichte====history
Gestalt====shape
Gestern====Yesterday
Gewebe====tissue
Gib====Give
Give====Give
Goodbye====Goodbye
Gott====God
Gras====grass
Gretel====Gretel
Grollen====Rumble
Gruppensitzungen====Group sessions
Gut====Well
Guten====Good ones
Hab====Have
Habt====Have
Hallo====Hello
Halt====Stop
Handy====mobile
Handys====Cell phones
Hannah====Hannah
Hase====Hare
Hast====Has
Haudini====Haudini
Haufen====heap
Haus====House
Hause====Home
Heide====pagan
Helge====Helge
Herr====Mr
Herrschaft====Domination
Hexe====witch
Hey====Hey
Hi====Hi
Hier====Here
Hierbei====Here
Hilfe====Help
Hm====Hm
Hof====court
Hotel====hotel
Hotelzimmer====Hotel room
Houdini====Houdini
Hunde====dogs
Hungerstreik====Hunger strike
Hälfte====half
Hältst====Hold
Hänsel====Hansel
Hätte====Would have
Häuser====Houses
Höhe====height
Höhlen====caves
Hör====Listen
Hören====Listen
Ich====I
Ihr====your
Ihre====Your
Ihren====Their
Illusion====illusion
Im====in the
In====In
Irgendwie====Somehow
Irgendwo====Somewhere
Irrenhaus====Madhouse
Ist====Is
Ja====Yes
Jacken====Jackets
Jackpot====jackpot
Jahr====year
Jahren====Years
Jemand====Someone
Jenseits====Beyond
Johlen====Hoot
Joint====joint
Jonas====Jonas
Kapazitäten====capacities
Kapuzenpulli====Hoodie
Katharina====Catherine
Keine====No
Keiner====None
Keller====basement, cellar
Keuchen====Panting
Kilometer====kilometre
Kind====child
Kinder====children
Kinderleiche====Child's corpse
Kinderrufe====Child cries
Klar====Clear
Klasse====class
Klaviermusik====Piano music
Kleinen====Little ones
Klicken====click
Klänge====Sounds
Knacken====Crack
Kollaps====collapse
Komm====come over
Kommst====Come
Kommt====Come
Kopf====head
Krachen====Crash
Kraftwerks====Power plant
Kreditrückzahlung====Loan repayment
Kreis====circle
Kriege====Wars
Kunden====Customers
Können====Can
Könnt====Can
Könntest====Could
Kümmer====Worry
Laber====Babble
Lauft====Running
Laut====According to
Lay====Lay
Leben====Life
Letzte====Latest
Leute====People
Licht====light
Liebe====love
Lied====song
Like====Like
Lkw====truck
Loch====hole
Los====Come on
Luft====air
Löcher====Holes
Machst====Do
Mads====Mads
Mafia====mafia
Magnus====Magnus
Mama====mummy
Manche====Some
Manchmal====Sometimes
Mann====man
Markt====market
Martha====Martha
Matrix====matrix
Maul====Mouth
Maßnahmen====activities
Medikamente====Medication
Meiler====Pile
Mein====My
Melancholische====Melancholy
Mhm====Mmm
Michael====Michael
Mikkel====Mikkel
Mir====Me
Mit====With
Miteinander====Together
Monate====Months
Morgen====tomorrow
Musik====music
Musst====Have to
Mut====courage
Mutter====mother
Mörder====killer
Na====N / A
Nachbarn====neighbours
Nachrichtensprecher====news reporter
Nacht====night
Narben====scar
Nein====No
Neither====Neither
Netz====network
Neutronenmaterie====Neutron matter
Neuweiher====Neuweiher
Nicht====Not
Nichts====Nothing
Niemand====Nobody
Nimmst====Take
Noch====Still
Nor====Nor
Notruf====Emergency call
Nur====Just
Ob====If
Obendorf====Obendorf
Oder====Or
Okay====OK
Open====Open
Panikmache====Scare tactics
Papa====father
Papi====Papi
Person====person
Perspektive====perspective
Pfadfinder====scout
Piepton====Beep
Pläne====plans
Pochen====Throbbing
Polizist====police officer
Popmusik====pop music
Prasseln====Patter
Presse====Press
Probleme====Problems
Pulli====Sweater
Put====Put
Raum====room
Raunen====Murmur
Rauschen====Noise
Redebedarf====Need to speak
Regierung====government
Regina====Regina
Region====region
Reifenprofile====Tire treads
Richtung====direction
Riesenschlange====Giant snake
Right====Right
Rufe====Calls
Röcheln====Rattle
Sache====Thing
Scheiß====Shit
Scheißdreck====Shit
Scheiße====crap
Scheißlampen====Fucking lamps
Scheißpulli====Fucking sweater
Schlimmste====Worst
Schuldirektorin====School principal
Schule====school
Schulklingel====School bell
Schultag====school day
Schwester====sister
Schön====Nice
Schüleraustausch====Student exchange
Sein====Be
Sekunden====Seconds
Selbst====Self
Sessel====armchair
Seufzen====sigh
Shit====shit
Sicherheit====security
Sie====you
Siedlung====settlement
Simulation====simulation
Sirenen====Sirens
So====So
Sohn====son
Solche====Such
Sollte====Should
Sollten====Should
Solltest====Should
Sommer====summer
Spasti====Spasti
Spastis====Spasticity
Sphärischer====More spherical
Sporttasche====Sports bag
Spur====track
Spuren====traces
Stadt====city
Statistiken====statistics
Stehst====Are standing
Stimmengewirr====Babble of voices
Straftat====Offense
Straftatenrate====Crime rate
Strang====strand
Strom====electricity
Sturz====Fall
Stöhnen====moan
Stücken====Pieces
Sucht====Addiction
Supernova====Supernova
Surren====Whirring
Szene====scene
Tag====Day
Tage====Days
Tagen====Days
Tasche====bag
Telefon====phone
Tellerrand====Edge of the plate
Text====text
Thema====theme
Therapeut====therapist
Tiedemann====Tiedemann
Toast====toast
Toter====Dead
Training====training
Transporter====Transporter
Traum====dream
Trick====trick
Träumen====dream
Tür====door
Türsummer====Door buzzer
Uhr====Clock
Ulrich====Ulrich
Ultimate====Ultimate
Um====Around
Umkreis====Radius
Umziehen====Move
Unabänderliches====Immutable
Und====And
Unendlichkeit====infinity
Unmöglich====Impossible
Uns====Us
Unterricht====classes
Unterscheidung====Distinction
Urlaub====vacation
Vater====father
Vergangenheit====past
Versammlung====Assembly
Versammlungen====Gatherings
Verschwinden====Disappear
Verstand====understanding
Verstecken====Hide
Verwarnung====warning
Veränderliches====Changeable
Vielleicht====Maybe
Vorgesetzten====Supervisor
Wahnsinn====madness
Wald====Forest
Waldrand====Edge of the forest
Waldweg====Forest path
War====Was
Warum====Why
Was====What
Watch====Watch
Weg====path
Weisheit====wisdom
Weißt====Know
Welt====world
Wenn====If
Wer====who
What====What
Wichtig====Important
Wichtiges====Important
Wie====How
Wieso====How so
Will====Want
Willkommen====welcome
Winden====Winches
Wir====We
Wissenschaftler====scientist
Wo====Where
Wochen====Weeks
Wochenende====weekend
Wollen====Want
Wort====word
Wäsche====Laundry
Wölfe====Wolves
You====You
Zack====Zack
Zauberer====wizard
Zeit====time
Zeitpunkt====time
Zentralregion====Central region
Zeug====Stuff
Zu====To
Zuge====Trains
Zukunft====future
Zweites====Second
a====a
ab====from
aber====but
abgebogen====turned
abgehauen====escape
abgeht====going off
abgemurkst====messed up
abgeschafft====abolished
abgeschickt====sent
abwarten====wait
adoptiert====adopted
alle====all
allein====alone
allem====everything
aller====all
alles====everything
als====as
also====so
am====at the
an====at
and====other
anderen====other
angehört====listened to
angerufen====called
angrenzenden====adjacent
arms====arms
asleep====asleep
atmet====breathes
auch====also
auf====on
aufeinander====on each other
aufgebaut====built up
aufgefunden====found
aufgelöst====dissolved
aus====out
ausgehen====go out
ausschließen====exclude
aussetzen====expose
außerdem====also
baby====infant
bedrohliche====threatening
befragt====questioned
begreifen====understand
bei====at
beides====both
beim====at the
bellen====bark
bereits====already
beruhigt====calmed down
besser====better
betriebenen====operated
bewilligt====approved
bin====am
bis====to
bist====are
bitte====You're welcome
bring====bring
brüllt====roars
bäm====bam
cappella====cappella
come====come
da====there
dachte====thought
dachtest====thought
dafür====for this
dahin====there
damals====back then
dann====then
darauf====thereon
darf====may
das====the
dass====that
dein====your
deine====yours
deinem====your
deinen====yours
deiner====yours
dem====the
den====the
denn====because
der====the
des====of
deutlich====clear
deutschen====German
dich====you
die====the
diese====these
diesem====this
dir====to you
do====do
doch====but
donnert====thunders
dort====There
doubts====doubts
down====down
drauf====on it
drin====inside
drüber====over it
du====you
dumpfes====dull
dunkle====dark
durch====by
durcheinander====confused
durchkämmt====combed through
durchsucht====searched
düstere====gloomy
easy====easy
eben====just
echt====real
egal====no matter
eigenen====own
ein====a
eine====a
einem====one
einen====one
einer====one
einfach====easy
eingesperrt====locked
eins====one
einsperren====lock up
else====else
entfernte====distant
entführt====kidnapped
entsteht====arises
er====he
erhängt====hung
erklingt====sounds
erklären====to explain
erklärt====explained
erleichtertes====relieved
erst====first
ertönt====sounds
erzählen====tell
erzählt====tells
es====it
essen====eat
etwas====something
euch====to you
eurem====yours
euren====yours
eurer====yours
ever====ever
ewig====forever
ewigen====eternal
ey====ey
fahr====drive
fall====case
falsch====not correct
finden====Find
findet====finds
folgen====consequences
frage====question
frei====free
freien====free
fresse====eat
freuen====looking forward
fröhliche====happy
frühstücken====have breakfast
fuck====fuck
fun====fun
fährt====moves
fällt====falls
fände====would find
fängt====catches
fünf====five
für====For
fürs====for
ganz====all
ganze====whole
ganzen====whole
gar====at all
geben====give
gedacht====thought
gedauert====lasted
gefunden====found
gegangen====went
geheimnisvolle====mysterious
gehen====walk
gehst====go
geht====goes
gehört====belongs
geil====hot
geklaut====Stolen
gekommen====came
gelagert====stored
gelesen====read
geliebt====loved
gemacht====made
genau====exactly
genauso====just like that
geplanten====planned
gerade====just
geschlafen====slept
geschmiedet====forged
geschrieben====written
gesehen====seen
gespielt====plays
gewollt====wanted
gib====give
gibst====give
gibt====gives
gilt====applies
glaube====faith
glaubst====believe
glaubt====believes
gleich====equal
gleichförmig====uniform
glotzen====gawk
glotzt====stares
got====got
grad====Degree
gucken====look
guckst====look
gut====Well
gute====quality
hab====have
habe====have
haben====to have
habt====have
halben====half
hallendes====echoing
hast====has
hat====Has
have====have
having====having
heißt====called
here====here
hergebeten====invited here
heulen====howl
heute====today
hier====here
hin====down
hinterlassen====leave
hinzunehmen====to accept
hochkochen====boil up
hoher====higher
holen====to fetch
holt====get
hält====holds
hätte====would have
ich====I
ihn====him
ihr====you
im====in the
immer====always
in====in
irgendetwas====anything
irgendwann====Sometime
irgendwas====anything
irgendwelche====any
irgendwem====somebody
is====is
ist====is
j====j
ja====Yes
jeden====everyone
jeder====everyone
jederzeit====at any time
jemand====someone
jetzigen====present
jetzt====now
kann====can
kehrt====returns
kein====no
keine====no
keinem====none
keinen====none
keucht====gasps
klar====clear
kleinen====small
klingeln====ring
klingelt====rings
know====know
komm====come over
kommen====come
kommst====come
korrigier====correct
kotzt====pukes
krank====ill
kurzer====shorter
kurzes====short
können====can
könnt====can
könnte====could
lacht====laughs
lang====long
lange====Long
langer====longer
langweilig====boring
lauter====volume up
lautes====loud
lebt====lives
leid====suffering
leise====quietly
letzten====last
letzter====last
liebe====love
liegt====lies
lies====read
like====Like
linear====linear
listen====list
locker====relaxed
look====look
los====Come on
loving====loving
lächerlich====ridiculous
längsten====longest
läufst====running
läuft====running
machen====do
machst====do
macht====makes
mal====times
man====man
me====me
medizinischen====medical
mehr====more
mein====my
meine====my
meinem====my
meinen====mean
meiner====mine
meisten====most
melancholische====melancholy
mich====me
mir====me
mit====With
miteinander====together
mitgemacht====participated
morgen====tomorrow
muss====got to
musst====have to
my====my
möchte====would like to
müssen====have to
müssten====would have to
n====n
nach====to
nachher====later
naht====seam
nein====No
neither====neither
nen====nen
nervst====annoying
nett====kind
neuen====new
never====never
next====next
nicht====Not
nichts====Nothing
nie====never
niedrigste====lowest
niemals====No way
niemand====nobody
nimmt====takes
no====no
noch====still
now====now
nun====now
nur====just
nützt====useful
ob====if
oder====or
ohne====without
okay====OK
on====on
one====one
out====out
passieren====happen
passiert====happens
passt====fits
piept====beeps
quatschen====chat
rauchen====smoke
rauskann====can get out
re====re
record====record
reden====talk
redest====talk
regnen====rain
rein====purely
rennen====run
riesigen====huge
right====right
round====round
ruf====call
ruhige====calm
rum====rum
s====s
sag====say
sagen====say
sagt====says
schafft====creates
schauen====watch
scheiß====shit
scheiße====crap
scheißlangweilig====fucking boring
schikaniert====bullied
schlechtem====bad
schlechtes====bad
schluchzend====sobbing
schluchzt====sobs
schläft====is sleeping
schlägt====beats
schon====beautiful
schrittweise====gradually
schwarzer====black
schwarzes====black
schwer====heavy
schwärzeste====blackest
schön====beautiful
schöne====lovely
scream====scream
seh====see
sein====be
seine====his
seit====since
selber====himself
set====set
setzt====puts
sich====yourself
sicher====for sure
sicherlich====certainly
sie====you
sights====sights
sign====sign
sind====are
sitzt====sits
so====so
sofort====right away
soll====should
some====some
sondern====rather
sonst====otherwise
sorgen====to care
sozusagen====so to speak
spannungsvolle====exciting
spin====spin
sprechen====speak
sprecht====speak
spät====late
später====later
spüren====feel
stehst====are standing
sterbe====die
stumme====mute
störungsfrei====trouble-free
suchen====search
surren====whir
surrendes====whirring
t====t
teilt====Splits
that====that
the====the
to====to
tot====dead
total====total
totes====dead
trampeln====trample
trotzdem====Nevertheless
tun====to do
tut====does
um====around
und====and
unheilvolle====ominous
unheimliche====scary
uns====us
unser====our
unsere====our
unserem====our
unterm====under
unterscheiden====distinguish
up====up
ve====ve
verbunden====connected
verdächtigt====suspected
vergessen====to forget
verhungerst====starving
verhungert====starved
verhärtet====hardened
verkalkuliert====miscalculated
verkaufe====sell
verkaufst====sell
verknotet====knotted
verkrampft====cramped
verläuft====runs
vermisst====missing
verpasst====lost
verschwindet====disappears
verschwunden====disappeared
verschwundenen====missing
verschwundenes====disappeared
verstanden====Roger that
verstehe====understand
verstummt====falls silent
vertragen====tolerate
vertrauen====trust
viele====lots
vielleicht====maybe
vier====four
voll====full
vom====from
von====of
vor====in front
voranschreitet====advances
vorbei====past
vorbeischauen====drop by
vorliegt====is present
vorne====front
vu====vu
wann====when
want====want
war====was
waren====were
warst====were
warte====wait
warum====Why
was====What
way====way
wechseln====switch
wechselt====changes
weg====path
weil====because
weiter====further
weiß====White
welche====Which
welchen====which
wem====whom
wenn====if
werden====become
wert====value
when====when
wie====how
wieder====again
wiedererkennen====recognize
wiederhole====repeat
wiederholt====repeated
will====want
willst====want
wir====we
wird====becomes
wirklich====really
wisst====know
wohnt====lives
wollte====wanted
wolltest====wanted
worum====for what
wovon====About what
wurde====has been
wurden====were
you====you
your====your
zahlen====numbers
zehn====ten
zieh====pull
ziehen====pull
zu====to
zugelassene====approved
zum====to the
zur====to
zurück====back
zusammenhalten====stick together
zusammenstürzende====collapsing
zustimmende====consenting
zwar====though
zwei====two
zwischen====between
zögern====hesitate
Ächzen====groan
Ähm====Um
Über====over
ändern====to change
ängstliches====fearful
öffentlich====public
öfter====more often
über====above
überhaupt====at all
undefined====
